= Глоссарий

Словарь терминов, используемых в этом руководстве по ArchiMate 3.2.

ArchiMate:: Открытый стандарт языка моделирования архитектуры предприятия, разработанный The Open Group.

Бизнес-актор (Business Actor):: Сущность (человек, группа, организация), обладающая инструментальной идентичностью и автономией, исполняющая бизнес-роли.

Бизнес-роль (Business Role):: Набор поведений, который может исполнять бизнес-актор.

Бизнес-процесс (Business Process):: Совокупность связанных, структурированных действий или задач, выполняемых для достижения определённой цели.

Бизнес-функция (Business Function):: Высокоуровневая, стабильная единица поведения, характеризующаяся определённым набором компетенций.

Бизнес-объект (Business Object):: Предмет (информация), на который ссылается или который генерируется бизнес-процессами, функциями или взаимодействиями.

Бизнес-услуга (Business Service):: Интерфейс, предоставляемый бизнес-ролью или актором, позволяющий другим субъектам использовать его поведение.

Бизнес-взаимодействие (Business Interaction):: Взаимодействие между двумя или более бизнес-ролями или акторами.

Бизнес-событие (Business Event):: Точка во времени, отмечающая факт, что нечто произошло.

Прикладной компонент (Application Component):: Автономная, функционально определённая часть прикладной архитектуры, инкапсулирующая своё содержимое и инстанциирующаяся.

Прикладной сервис (Application Service):: Интерфейс, предоставляемый прикладным компонентом, позволяющий другим компонентам использовать его поведение.

Прикладная функция (Application Function):: Высокоуровневая, стабильная единица поведения, реализуемая прикладным компонентом.

Прикладной процесс (Application Process):: Совокупность связанных, структурированных действий, выполняемых прикладным компонентом.

Прикладное взаимодействие (Application Interaction):: Взаимодействие между двумя или более прикладными процессами или функциями.

Прикладное событие (Application Event):: Точка во времени в прикладной архитектуре, инициирующая или являющаяся результатом процесса/функции.

Данные (Data Object):: Структурированная информация, используемая или генерируемая прикладными процессами, функциями или взаимодействиями.

Узел (Node):: Физическая или виртуальная вычислительная единица, на которой размещается системное программное обеспечение и артефакты.

Оборудование (Equipment):: Физическое устройство (сервер, маршрутизатор и т.д.).

Системное программное обеспечение (System Software):: Программное обеспечение, управляющее и координирующее узлы (операционные системы, контейнерные оркестраторы и т.д.).

Артефакт (Artifact):: Файловая структура, реализующая прикладной компонент или системное программное обеспечение.

Путь (Path):: Логическое или физическое соединение между узлами.

Цель (Goal):: Высокоуровневое, качественное намерение или желаемое состояние.

Принцип (Principle):: Фундаментальное руководящее правило, формирующее принятие решений.

Требование (Requirement):: Конкретное, измеримое условие или возможность, необходимая для удовлетворения цели или принципа.

Ограничение (Constraint):: Ограничение, накладываемое на поведение или реализацию архитектуры.

Заинтересованная сторона (Stakeholder):: Внутренняя или внешняя сила, вызывающая изменение в организации.

Влияние (Influence):: Степень, с которой заинтересованная сторона может повлиять на мотивационный элемент или архитектуру.

Ресурс (Resource):: Актив, которым организация владеет или контролирует, способствующий реализации стратегических целей.

Капабилити (Capability):: Абстрактная способность организации выполнять определённую деятельность.

Ценность (Value):: Результат, имеющий положительное значение для заинтересованных сторон.

Стимул (Driver):: Внутренняя или внешняя сила, вызывающая изменение.

Сценарий (Scenario):: Описание возможной последовательности событий.

Рабочий пакет (Work Package):: Единица работы, выполняемая для достижения результата.

Доставляемый результат (Deliverable):: Результат выполнения рабочего пакета.

Реализация (Implementation Event):: Событие, происходящее в ходе реализации или миграции.

Фаза (Phase):: Период времени, в течение которого сохраняется относительно стабильное состояние архитектуры.

Путь миграции (Migration Path):: Отношение между двумя фазами, указывающее направление перехода.

Отношение (Relationship):: Связь между элементами модели (например, Реализация, Обслуживание, Назначение, Доступ, Поток, Триггеринг, Ассоциация, Композиция, Аггрегация, Специализация).

Слой (Layer):: Группировка элементов ArchiMate по аспектам архитектуры (бизнес, приложение, технология, мотивация, реализация).